wwwwwwwwwwwwwwwwwwwwwwwwwwwwwwww
wq             T              tw
w                              w
w                              w
w                              w
w                              w
w                              w
w                              w
w                              w
w                              w
w                              w
w                              w
w                              w
w     s                    e   w
w                              w
w                              w
w                              w
wwwwwwwwwwwwwwwwwwwwwwwwwwwwwwww
