wwwwwwwwwwwwwwwwwwwwwwwwwwwwwwww
w                              w
w     Tn                    t  w
w                              w
w                              w
w                              w
w                              w
w                              w
w                              w
w                              w
w                              w
w                              w
w                              w
w     s                   e    w
w                              w
w                              w
w                              w
wwwwwwwwwwwwwwwwwwwwwwwwwwwwwwww
