wwwwwwwwwwwwwwwwwwwwwwwwwwwwwwww
w                              w
w     T                     t  w
w                              w
w                              w
w                              w
w                              w
w                              w
w                              w
w                              w
w                              w
w                              w
w                              w
w     s                   e    w
w                              w
w                              w
w                              w
wwwwwwwwwwwwwwwwwwwwwwwwwwwwwwww
